#####################################################
#@..#...............................................#
#...................................................#
#####...............................................#
#.............#.....................................#
#......#............................................#
#...................................................#
#...................................................#
#...................................................#
#...................................................#
#...................................................#
#...................................................#
#...................................................#
#...................................................#
#...................................................#
#####################################################